0
xxxxxxxxxxxxxxx
xxx         x x
xxx        x  x
xx     x      x
xxx   x       x
x  x x  x    xx
x  xx      x  x
xx x    x     x
xx x        x x
x x x         x
x x x   x     x
x  xx    x   xx
xxx          xx
xxx    x      x
x x   x       x
x  x    x  x  x
x    x  x  x  x
x xx    x   x x
xxx       x  xx
x x     x     x
x xx      x   x
x   x x     x x
x x    x    x x
xxx    x  S   x
xxx          xx
xx    x     x x
x x     x  x  x
x x x         x
xx  x     x  xx
xxx x    x   xx
xx       x    x
x  x x    x x x
x  x  x       x
      x x x   x
xxxxxxxxxxxxxxx
