0
xxxxxxxxxxxxxxx
xx x       x xx
xx  x    x    x
x  xx      x  x
x  x  x    x  x
xx x  x       x
   xx         x
xx   x        x
xxx   x       x
x      x   x  x
x xx  x       x
x x   x   x   x
xx x          x
x   x x       x
xx       x    x
x   x x   x   x
x  xx x       x
xx   x x      x
x   xx     x  x
x    x  x     x
x  xx   x     x
x  xx         x
xxx   x  x  x x
x  xx         x
xx x x     x  x
x    xx  x  Sxx
x xx x        x
x x x   x     x
xxx    x x    x
xxx           x
xx x          x
x x x     x  xx
xxx           x
xx x    x  x  x
xxxxxxxxxxxxxxx
